⠀⠀⠀⠀⠀⠀⠀⠀⣠⠞⠁⠀⠀⠀⠀⠀⢠⡄⠀⠀⠀⠀⠀⠀⠀⠀⠀⠀⠀⠀⠀⠀⠀⠀⠀⠀⠀⠀⠀⠀⠀⠀⠉⢳⣤⣤⣀⣀⠀⠀
⣶⣶⣶⣶⣾⠟⣩⠟⠁⠀⠀⢀⠎⠀⠀⡰⠋⠀⠀⠀⠀⡴⠃⠀⠀⠀⠀⠀⠀⠀⠀⠀⠀⠀⠀⠀⠀⠀⠀⠀⠀⠀⠀⠀⠹⣿⣄⠙⠿⣷
⣿⣿⣿⠏⢉⡾⠃⠀⠀⠀⢀⠆⠀⠀⠰⠁⠀⠀⠀⠀⡜⠁⠀⠀⠀⣰⠂⠀⠀⠀⠀⠀⠀⠀⠀⠀⠀⠀⠀⠀⠀⠀⠀⠀⠀⠘⢿⣧⠀⢸
⣿⣿⠉⣰⡟⠁⠀⠀⠀⢠⠎⠀⠀⠀⠀⠀⠀⠀⠀⢰⠁⠀⠀⡰⢱⠃⠀⠀⠀⠀⠀⠀⠀⠀⠀⠀⠀⠀⢀⠀⠀⠀⠀⠀⠀⠀⠈⢿⣧⠀
⣿⠉⢰⡟⠀⠀⠀⠀⢀⠏⠀⠀⠀⠀⠀⠀⠀⠀⣰⡏⠀⠀⢠⢇⠇⠀⠀⠀⠀⠀⠀⠀⠀⠀⠀⠀⠀⠀⠀⢣⠀⠀⠀⠀⠀⠀⠀⠈⢿⣧
⡿⢠⣿⠁⠀⠀⠀⠀⡼⠀⠀⡆⠀⠀⠀⠀⠀⡼⡣⡇⠀⠀⠘⢸⠀⠀⠀⠀⠀⢀⠀⠀⠀⠀⠀⠀⠀⠀⠀⠈⢧⠀⠀⠀⠀⠀⠀⠀⠈⢿
⡇⡞⠙⠀⠀⠀⠀⣸⠁⠀⢸⠀⠀⠀⠀⠀⣼⡟⠁⡇⠀⠀⠀⡇⠀⠀⠀⠀⢠⣿⠀⠀⠀⠀⠀⡆⠀⠀⠀⠀⠘⡆⠀⠀⠀⠀⠀⠀⠀⠈
⣿⠁⠀⠀⠀⠀⠀⡇⠀⠀⣸⠀⠀⠀⠀⢀⣻⠀⠀⢸⡀⠀⠀⢳⡀⠀⠀⠀⣞⢸⣆⠀⠀⠀⢸⡀⠀⢰⠀⠀⠀⢳⠀⠀⠀⠀⠁⠀⠀⠀
⠇⠀⠀⠀⠀⠀⢸⠀⡀⠀⡟⣆⠀⠀⠀⢸⠧⠴⠆⠀⠳⡀⠀⠀⠳⡀⠀⢸⢻⠲⠼⢆⠀⠀⠀⣇⠀⢸⣆⠀⠀⠘⡆⠀⠀⠀⠀⠀⠀⠀
⠀⠀⠀⠀⠀⠀⣼⣴⡿⣔⣇⠉⠓⠦⣄⣸⠀⠀⠀⠀⠀⠻⠶⣄⣀⠙⠦⣸⡆⠀⠀⠀⠓⢤⡀⠸⡷⣄⢻⢦⡀⠀⢷⠀⠀⠀⡆⠀⠀⠀
⠀⠀⠀⠀⠀⠀⣿⠛⠀⠈⠉⠀⠀⠀⠀⠈⠁⠀⠀⠀⠀⠀⠀⠐⠨⠍⠉⠉⠛⠀⠀⠀⠀⠀⠉⠙⠚⠬⠟⠃⠻⡦⣼⠀⠀⣆⡇⠀⠀⠀
⠀⡀⢰⠀⠀⢠⡇⠀⠀⠀⠀⠀⠀⠀⠀⠀⠀⢀⠀⠀⠀⠀⠀⠀⠀⠀⠀⠀⠀⢀⣀⠤⠀⠀⠀⠀⠀⠀⠀⠀⠀⠙⢿⡆⢀⢿⠁⠀⠀⠀
⠀⠸⡄⣧⠀⢸⣃⣤⣖⣻⣿⣿⠿⣿⣿⣟⣓⣲⣭⣑⠀⠀⠀⠀⠀⠀⠀⠀⢈⡥⣶⣺⣿⣿⣿⣿⣷⠲⠦⣄⡀⠀⠀⡇⢸⡼⠀⠀⠀⠀
⠀⠀⢱⡘⡆⢸⡀⠀⠀⠀⠀⠀⠀⠀⠀⠀⠀⠀⠀⠀⠀⠀⠀⠀⠀⠀⠀⠀⠈⠉⠉⠉⠀⠈⠉⠉⠉⠉⠉⠓⠛⠓⠲⣧⡇⠃⠀⠀⠀⠀
⠀⠀⠀⢳⡸⡄⡇⢠⡀⠀⠀⠀⠀⠀⠀⠀⠀⠀⠀⠀⠀⠀⠀⠀⠀⠀⠀⠀⠀⠀⠀⠀⠀⠀⠀⠀⠀⠀⠀⠀⠀⠀⠀⡿⢠⠀⠀⠀⠀⠀
⠀⠀⠀⠀⢳⡹⣇⠈⠀⠀⠀⠀⠀⠀⠀⠀⠀⠀⠀⠀⠀⠀⠀⠀⠀⠀⠀⠀⠀⠀⠀⠀⠀⠀⠀⠀⠀⠀⠀⠀⠀⠀⢀⢃⡇⠀⠀⠀⠀⠀
⠀⠀⠀⠀⠀⠱⣽⡀⠀⠀⠀⠀⠀⠀⠀⠀⠀⠀⠀⠀⠀⠀⠀⠀⠀⠀⠀⠀⠀⠀⠀⠀⠀⠀⠀⠀⠀⠀⠀⠀⠀⠀⣸⡜⠀⠀⠀⢀⠀⠀
⠀⠀⠀⠀⠀⠀⠹⣧⠀⠀⠀⠀⠀⠀⠀⠀⢦⡀⠀⠀⠀⠀⠀⠀⠀⠀⠀⠀⠀⠀⠀⠀⠀⠀⠀⠀⠀⠀⠀⠀⠀⢀⣯⠁⠀⠀⢀⠎⠀⠀
⠀⠀⠀⠀⠀⠀⠀⠻⣇⠀⠀⠀⠀⠀⠀⠀⠀⠙⠫⠍⣑⣒⣒⣒⣒⣒⣒⣒⠲⠚⠁⠀⠀⠀⠀⠀⠀⠀⠀⠀⠀⣼⠃⠀⠀⣠⠋⠀⠀⠀
⠀⠀⠀⠀⠀⠀⠀⠀⠸⡄⠀⠀⠀⠀⠀⠀⠀⠀⠀⠀⠀⠀⠀⠀⠀⠀⠀⠀⠀⠀⠀⠀⠀⠀⠀⠀⠀⠀⣀⡄⢲⠇⠀⢀⡞⠁⠀⠀⠀⠀
⠀⠀⠀⠀⠀⠀⠀⠀⠀⢿⣌⡒⠤⢄⡀⡀⠀⠀⠀⠀⠀⠀⠀⠀⠀⠀⠀⠀⠀⠀⠀⠀⠀⠀⠀⠤⠒⠉⣉⣵⠟⠀⡠⠋⠀⠀⠀⠀⠀⠀
⠀⠀⠀⠀⠀⠀⠀⠀⠀⠸⡄⠉⢹⠖⠲⣤⢭⣀⣀⣀⡀⠀⠀⠀⠀⠀⠀⠀⠀⠀⣀⣉⣁⣠⠼⠶⡶⠛⢉⡟⡠⠊⠀⠀⠀⠀⠀⠀⠀⠀
⠀⠀⠀⠀⠀⠀⠀⠀⠀⠀⣧⠀⡸⠀⣰⡟⢠⣷⣷⠻⣿⣿⠭⠭⠽⣿⡏⠿⣫⡽⢿⣟⣧⢸⠀⢰⠃⣀⣾⠟⠁⠀⠀⠀⠀⠀⠀⠀⠀⠀
⠀⠀⠀⠀⠀⠀⠀⠀⠀⠀⢸⢰⠃⣰⠟⣠⣿⡿⣻⠀⠀⠙⠛⠛⠶⠒⠛⠋⠉⠀⢸⡝⢿⣮⡆⢸⢈⡞⠁⠀⠀⠀⠀⠀⠀